#################
#..%.*$.&.$*.%..#
#....*$...$*....#
#.**.*$...$*.**.#
#.&*?.......?*&.#
#..***********..#
#.***.......***.#
#...............#
#..%..*.@.*..%..#
#################