#################
#..%..$.&.$..%..#
#.....$...$.....#
#***..$...$..***#
#.&*.........*&.#
#.**..*****..**.#
#..%.........%..#
#...............#
#..%..*.@.*..%..#
#################
