#################
#..%**$.!.$**%..#
#..**.$.^.$.**..#
#.....$...$.....#
#.....*****.....#
#.*****...*****.#
#..%.........%..#
#%.............%#
#..%.?*.@.*?.%..#
#################