#################
#.*.*.*.*.*.*.*.#
#*.*.*.*.*.*.*.*#
#.*.*.*.*.*.*.*.#
#*.*.*.*.*.*.*.*#
#.*.*.*.*.*.*.*.#
#*.*.*.*.*.*.*.*#
#.*.*.*.*.*.*.*.#
#*.*.*.*@*.*.*.*#
#################