#################
#..%..*.&.*..%..#
#.....*...*.....#
#..%..*...*..%..#
#...............#
#...............#
#..%..*...*..%..#
#.....*...*.....#
#..%..*.@.*..%..#
#################
