#################
#..%.*$.&.$*.%..#
#....*$...$*....#
#.**.*$...$*.**.#
#.&*.........*&.#
#..*??.....??*..#
#.*************.#
#...............#
#..%..*.@.*..%..#
#################