#################
#..%..$.!.$..%..#
#.....$.^.$.....#
#...*.$...$.*...#
#...*.......*...#
#...*.......*...#
#..%*********%..#
#%.............%#
#..%.?*.@.*?.%..#
#################