#################
#..%..$.&.$..%..#
#.....$...$.....#
#***..$...$..***#
#.&*.........*&.#
#.**.........**.#
#..%..*****..%..#
#...............#
#..%..*.@.*..%..#
#################
